||||||||||||||||||||||||||||||||||||||||||||||||||||||||||||||||||||||
S   ||  |||||              | |               |                       |
| |             ||||||||||   | ||||||||||||| | ||||||||||||||||||||| |
| ||||||||  |              |||        |||||| | |                     |
|        |  |  |||  |||||  |||||||||         | | ||||||||||||||||||| |
| ||||||||  |  |||||||                 |||   | | |                 | |
| |                   |||||||| |   ||||||||  | | ||||||||||||||||| | |
| ||||||||||||||||||        || | | |      |  | |                   | |
|                  ||||||||||| | | | |||| |||| ||||||||||||||||||| | |
| ||||  |||||||||| |         |     | |    |                      | | |
| |              | | | | | ||||||||| |||||| |||||||||||||||||||  ||| |
| |  |||||||||||   | | | | |     |          |                      | |
| |           |||  | | | | | ||||| ||||||||||||||||||||||||||||||| | |
| | || ||||||||||  | | | |||                                     | | |
| | ||             | | | ||||||||||||||| ||||||||||||||||||||||| | | |
| |||||||||||||||||| | |                     |                   ||| |
|                    ||||||||||||||||||||||||||||||||||||||||||| | | |
| ||||||||||||||||||||||||                   | ||||            | | | |
| |                        ||||||||||||||||| |       ||||||||| | | | |
| |  | ||||||||||||||| |||||                 ||||||| |       | | | | |
| |  |||||||           |     |||||||||||  ||||||   | | ||||||| | | | |
| |        | ||||||||| | |||||                 | | | |         | |   |
| |||||||| | | ||||  | |       ||||||| ||||||  | | | ||||||||||| | | |
|            |         | ||||  |       |         | |             | | G
||||||||||||||||||||||||||||||||||||||||||||||||||||||||||||||||||||||
